111121212121
222212121212
1211313
13
13
1313131313
3131313131313
