1111111111111111111111111111111111
1E000000000000C00000C0000000000011
1010010100100000101001000000010101
1010010010101010001001000000010101
1P0000C00C00C000000000001111111111
1111111111111111111111111111111111